0,0,0,0,0,0,0,0,0,0,0,0,0,0,0,0,0,0,0,0,0,0,0,0,0,0,0,0,0,0,0,0,
0,0,0,0,0,0,0,0,0,0,79,80,81,80,80,80,80,80,84,0,0,0,0,0,0,0,0,0,0,0,0,0,
0,0,0,0,79,80,80,80,80,80,20,0,0,0,0,0,0,0,103,0,0,0,0,0,0,0,0,0,0,0,0,0,
0,0,0,0,98,0,0,0,0,0,0,0,0,0,0,0,0,0,21,84,0,0,0,0,0,0,0,0,0,0,0,0,
0,0,0,0,98,0,0,0,0,0,0,0,0,0,0,0,0,0,0,103,0,0,0,0,0,0,0,0,0,0,0,0,
0,0,0,79,20,0,0,0,0,0,0,0,0,0,0,0,0,0,0,103,0,0,0,0,0,0,0,0,0,0,0,0,
0,0,0,98,0,0,0,0,0,0,0,0,0,0,0,0,0,0,0,21,84,0,0,0,0,0,0,0,0,0,0,0,
0,0,0,98,0,0,0,0,0,0,0,0,0,0,0,0,0,0,0,0,103,0,0,0,0,0,0,0,0,0,0,0,
0,79,80,20,0,0,0,0,0,0,0,0,0,0,0,0,0,0,0,0,21,84,0,0,0,0,0,0,0,0,0,0,
0,98,0,0,0,0,0,328,328,0,0,0,0,0,0,0,0,0,0,0,0,103,0,0,0,0,0,0,0,0,0,0,
0,98,0,0,0,0,0,0,0,0,0,0,0,0,0,0,0,0,0,0,0,103,0,0,0,0,0,0,0,0,0,0,
0,98,0,0,0,0,0,0,0,0,0,0,0,0,0,0,0,0,0,0,0,21,83,83,84,0,0,0,0,0,0,0,
0,98,0,0,0,0,0,0,0,0,0,0,0,0,0,0,0,0,0,0,0,0,0,0,21,83,83,83,84,0,0,0,
0,117,39,0,0,0,0,0,0,0,0,0,0,0,0,0,0,0,0,0,0,0,0,0,0,0,0,0,21,84,0,0,
0,0,98,0,0,0,0,0,0,0,0,0,0,0,0,0,0,0,0,0,0,0,0,0,0,0,0,0,0,103,0,0,
0,0,98,0,0,0,0,0,0,0,0,0,0,0,0,0,0,0,0,0,0,0,0,0,0,0,0,0,0,103,0,0,
0,0,117,39,0,0,0,0,0,0,0,0,0,0,0,0,0,0,0,0,0,0,0,0,0,0,0,0,0,103,0,0,
0,0,0,98,0,0,0,0,0,0,0,0,0,0,0,0,0,0,0,0,0,0,0,0,0,0,0,0,0,103,0,0,
0,0,0,117,39,0,0,0,0,0,0,0,0,0,0,0,0,0,0,0,0,0,0,0,0,0,0,0,0,103,0,0,
0,0,0,0,98,0,0,0,0,0,0,0,0,0,0,0,0,0,0,0,0,0,0,0,0,0,0,0,0,103,0,0,
0,0,0,0,98,0,0,0,0,0,0,0,0,0,0,0,0,0,0,0,0,0,0,0,0,0,0,0,0,103,0,0,
0,0,0,0,98,0,0,0,0,0,0,0,0,0,0,0,0,0,0,0,0,0,0,0,0,0,0,0,0,103,0,0,
0,0,0,0,98,0,0,0,0,0,0,0,0,0,0,0,0,0,0,0,0,0,0,0,0,0,0,0,40,122,0,0,
0,0,0,0,117,118,39,0,0,0,0,0,0,0,0,0,0,0,0,0,0,0,0,0,0,0,0,0,103,0,0,0,
0,0,0,0,0,0,117,39,0,0,0,0,0,0,0,0,0,0,0,0,0,0,0,0,0,0,0,0,103,0,0,0,
0,0,0,0,0,0,0,98,0,0,0,0,0,0,0,0,0,0,0,0,0,0,0,0,0,0,0,0,103,0,0,0,
0,0,0,0,0,0,0,98,0,0,0,92,0,0,0,0,0,0,0,0,0,0,0,0,0,94,0,0,103,0,0,0,
0,0,0,0,0,0,0,98,0,0,0,111,0,0,0,0,0,0,0,0,0,0,0,0,0,113,0,40,122,0,0,0,
0,0,0,0,0,0,0,117,39,0,0,111,0,0,0,0,0,0,0,0,0,0,0,0,0,113,0,103,0,0,0,0,
0,0,0,0,0,0,0,0,117,120,121,130,131,131,131,131,131,131,131,131,131,131,131,131,131,132,119,122,0,0,0,0,
0,0,0,0,0,0,0,0,0,0,0,0,0,0,0,0,0,0,0,0,0,0,0,0,0,0,0,0,0,0,0,0,
0,0,0,0,0,0,0,0,0,0,0,0,0,0,0,0,0,0,0,0,0,0,0,0,0,0,0,0,0,0,0,0,
