0,0,0,0,0,0,0,0,0,0,0,
0,0,0,0,0,0,0,0,0,0,0,
0,4992,4992,4992,4992,4992,4992,4992,4992,4992,0,
0,4992,4992,4992,4992,4992,4992,4992,4992,4992,0,
0,4992,4992,4992,4992,4992,4992,4992,4992,4992,0,
0,4992,4992,4992,4992,4992,4992,4992,4992,4992,0,
0,4992,4992,4992,4992,4992,4992,4992,4992,4992,0,
0,4992,4992,4992,4992,4992,4992,4992,4992,4992,0,
0,4992,4992,4992,4992,4992,4992,4992,4992,4992,0,
0,0,4992,0,0,0,0,0,0,0,0,
0,0,0,0,0,0,0,0,0,0,0,
