0,0,0,0,0,0,0,0,0,0,0,
0,0,0,0,0,0,0,0,4995,4996,0,
0,4934,4935,4936,4937,0,0,5253,5059,5060,0,
0,4998,4999,5000,5001,0,0,0,0,0,0,
0,5062,5063,5064,5065,0,0,0,0,0,0,
0,0,0,0,0,0,0,0,0,0,0,
0,0,0,0,0,0,0,5190,5191,0,0,
0,0,0,0,0,0,5252,5254,5255,0,0,
0,0,0,0,0,0,0,0,0,0,0,
0,0,0,0,0,0,0,0,0,0,0,
0,0,0,0,0,0,0,0,0,0,0,
