2,82,82,82,82,82,81,81,82,82,5,
41,121,121,121,121,121,120,120,121,121,44,
80,0,0,0,0,0,0,0,0,0,83,
80,0,0,0,0,0,0,0,0,0,83,
80,0,0,0,0,0,0,0,0,0,83,
80,0,0,0,0,0,0,0,0,0,83,
80,0,0,0,0,0,0,0,0,0,83,
80,0,0,0,0,0,0,0,0,0,83,
80,0,0,0,0,0,0,0,0,0,83,
197,1549,0,1550,199,198,198,198,198,199,200,
0,1629,1630,1631,0,0,0,0,0,0,0,
